ABE - abessive case
ABL - ablative case
ABS - absolutive case
ACC - accusative case
ADE - adessive case
AG - agentive case
AGT - agentive case
ALL - allative case
ANTE - antessive case
ASS - associative case
BEN - benefactive case
CENT - centric case
COM - comitative case
D - core dative case
DAT - dative case
DEL - delative case
DISTR - distributive case
ELA - elative case
ERG - ergative case
ESS - essive case
EVIT - evitative case
EXESS - exessive case
EXO - exocentric case
GEN - genitive case
ILL - illative case
INE - inessive case
INEL - inelative case
INS - instrumental case
INSTR - instrumental case
LAT - lative case
LOC - locative case
MLT - multiplicative case
MLTP - multiplicative case
NOM - nominative case
OBL - oblique case
PEG - pegative case
PER - perlative case
POST - postpositional case
POSTE - postessive case
POSTEL - postelative case
PRIV - privative case
PROL - prolative case
PROS - prosecutive case
PTV - partitive case
PURP - purposive case
QUOT - quotative case
SUBE - subessive case
SUBL - sublative case
SUPE - superessive case
TEMP - temporal case
TERM - terminative case
TRANSL - translative case (becoming)
VIA - vialis case
VOC - vocative case